	NO     /home/joaomigu/Documents/42_Projects/new_cub/assets/textures/NO.xpm
SO /home/joaomigu/Documents/42_Projects/new_cub/assets/textures/SO.xpm
WE /home/joaomigu/Documents/42_Projects/new_cub/assets/textures/WS.xpm
EA /home/joaomigu/Documents/42_Projects/new_cub/assets/textures/ES.xpm
F 220,100,0
C 225,30,0


        1111111111111111111111111
        1000000000110000000000001
        1011N00001110000000000001
        1001000000000000000000001
        1111111111111111111111111
111 111111011000001110000000000001
101 10000000011000001110111111111111
111 1110111111111011100000010001
111 1110111111111011101010010001
111 1000000110101011100000010001   
101 1000000000000001100000010001    
101 1000000000000001101010000001    
111 100000111010101111101111000111
111 1110111 1110101 101111010001
111 1111111 1111111 111111111111

