NO /home/joaomigu/Documents/42_Projects/new_cub/assets/textures/bonus/NO.xpm

SO /home/joaomigu/Documents/42_Projects/new_cub/assets/textures/bonus/SO.xpm
WE /home/joaomigu/Documents/42_Projects/new_cub/assets/textures/bonus/WS.xpm
EA /home/joaomigu/Documents/42_Projects/new_cub/assets/textures/bonus/ES.xpm

F /home/joaomigu/Documents/42_Projects/new_cub/assets/textures/bonus/floor.xpm
C /home/joaomigu/Documents/42_Projects/new_cub/assets/textures/bonus/ceiling_a.xpm

ANIM_DOOR /home/joaomigu/Documents/42_Projects/new_cub/assets/textures/bonus/door.ani

ANIM_FACE /home/joaomigu/Documents/42_Projects/new_cub/assets/textures/face.ani



                        11111111111
                        10000000001
                        10111111101
111111111111111111111111111111111D11111111111111111111111111111
100010010010010010001001000000000000100000000100000000000000001
100000000000000010001001000000000000100101100100000000000000001
1000E00000000000D000D00D000000000000111100111100000000000000001
100000000000000010001001000000000000000000000D00000000000000001
100010010010010010001001000000000000000000000100000000000000001
111111111111111111111111101111111111111111111111111111111111111
                        101111101
                        101100001
                        100001111
                        111111