NO /home/joaomigu/Documents/42_Projects/new_cub/assets/textures/NO_1.xpm

SO /home/joaomigu/Documents/42_Projects/new_cub/assets/textures/SO_1.xpm
WE /home/joaomigu/Documents/42_Projects/new_cub/assets/textures/WS_1.xpm
EA /home/joaomigu/Documents/42_Projects/new_cub/assets/textures/ES_1.xpm

F /home/joaomigu/Documents/42_Projects/new_cub/assets/textures/floor.xpm
C /home/joaomigu/Documents/42_Projects/new_cub/assets/textures/ceiling.xpm

ANIM_DOOR /home/joaomigu/Documents/42_Projects/new_cub/assets/textures/door.ani

ANIM_FACE                     /home/joaomigu/Documents/42_Projects/new_cub/assets/textures/face.ani

 1111111111111111
 1000000000000111
 10000000000001
 100S0000000001
 111D1110000001
 10000000000001
 10000000000001
 11111111111111
