	NO     /home/joaomigu/Documents/cub3d/assets/textures/NO_1.xpm
SO /home/joaomigu/Documents/cub3d/assets/textures/SO_1.xpm
WE /home/joaomigu/Documents/cub3d/assets/textures/WS_1.xpm
EA /home/joaomigu/Documents/cub3d/assets/textures/ES_1.xpm

F 200,100,20
C 250,30,0

1111
10N1
1111

1