NO /home/joaomigu/Documents/cub3d/assets/textures/NO_1.xpm

SO /home/joaomigu/Documents/cub3d/assets/textures/SO_1.xpm
WE /home/joaomigu/Documents/cub3d/assets/textures/WS_1.xpm
EA /home/joaomigu/Documents/cub3d/assets/textures/ES_1.xpm

F /home/joaomigu/Documents/cub3d/assets/textures/floor.xpm
C /home/joaomigu/Documents/cub3d/assets/textures/ceiling.xpm

ANIM_DOOR /home/joaomigu/Documents/cub3d/assets/textures/door.ani

ANIM_FACE                     /home/joaomigu/Documents/cub3d/assets/textures/face.ani

 11111111
 10000001
 10000001
 100S0001
 111D1111
 10000001
 10000001
 11111111
